1111111111111
1P00000000001
1C11111111111
101NNNNNNNNN1
101NNNENNNNN1
100NNNNNNNNN1
1111111111111