1111111111111111111111111111111111
1E000000000000000C000000C00000N001
1000001010010000010100100000010111
1000001001010101000100100000010101
1P0000N000C00C0000000000000N0000C1
1111111111111111111111111111111111