1111111111111111111111111111111111
1000000000000000000000000000000001
1111111111110000C00011111111111111
10011111000CCCCCCCCC00000000000001
10011111000CCCCCCCCC00000000000001
1000000000000011100000000000000001
1111111111000011100000000000000001
1000000000000000000000000000000001
1000000000000000000000000000000001
1111111111000011100000000000000001
1111111111000011100000000000000001
11111111110CCCCCCCCC00000000000001
10000000000CCCCCCCCC00000000000001
10000000000CCCCCCCCC00000000000001
1E00000000000000000000000000P00001
1111111111111111111111111111111111